記述をする	と	  主体と
注目を集める	が	   サポートベクターマシンが 
経験を行う	に を	  元に 学習を
進化を見せる	て は て において	 活躍している 特に 敵対的生成ネットワークは 加えて 生成技術において 
進化をいる	て は て において	 活躍している 特に 敵対的生成ネットワークは 加えて 生成技術において 
開発を行う	は	  エイダ・ラブレスは 
意味をする	に	 データに 
研究を進める	て	 費やして 
命令をする	で	   機構で
運転をする	に	  元に 
特許をする	まで に が	 2018年までに 日本が 
特許をいる	まで に が	 2018年までに 日本が 
運転をする	て に	 基づいて 柔軟に 
注目を集める	から は	  ことから ファジィは 関わらず 
制御をする	から	 少なさから  多少
研究を続ける	が て	 ジェフホーキンスが 向けて 
研究をいる	が て	 ジェフホーキンスが 向けて 
注目を集める	に	 急速に 
投資を行う	に で	 全世界的に 民間企業主導で 
探索を行う	で	  無報酬で 
推論をする	て	  経て
研究を行う	て	  始めており 
研究をいる	て	  始めており 
投資をする	は まで に	 韓国は 2022年までに 
反乱を起こす	て に対して	 於いて 人間に対して 
監視を行う	まで に	  歩行者まで  人工知能に
監視をせる	まで に	  歩行者まで  人工知能に
判断を介す	から	 観点から 
禁止を求める	に は が	  4月には ヒューマン・ライツ・ウォッチが 
禁止をいる	に は が	  4月には ヒューマン・ライツ・ウォッチが 
追及を受ける	て で は とともに と で	  暴露されており 公聴会では とともに 拒否すると 整合性で 
解任をする	て は	   含まれており Google社員らは 
解散をする	は が で	   Googleは 倫理委員会が 理由で 
話をする	は	 哲学者は みんな 
話をいる	は	 哲学者は みんな 
議論を行う	まで	 これまで けっこう 長時間 
議論をくる	まで	 これまで けっこう 長時間 
